P_t_schweinfurthii_Diana	P_t_schweinfurthii_Diana	P_t_schweinfurthii_Diana	P_t_schweinfurthii_Diana
P_t_schweinfurthii_Ikuru	P_t_schweinfurthii_Ikuru	P_t_schweinfurthii_Ikuru	P_t_schweinfurthii_Ikuru
P_t_schweinfurthii_Trixie	P_t_schweinfurthii_Trixie	P_t_schweinfurthii_Trixie	P_t_schweinfurthii_Trixie
P_t_ellioti_Akway_Jean	P_t_ellioti_Akway_Jean	P_t_ellioti_Akway_Jean	P_t_ellioti_Akway_Jean
P_t_ellioti_Banyo	P_t_ellioti_Banyo	P_t_ellioti_Banyo	P_t_ellioti_Banyo
P_t_ellioti_Basho	P_t_ellioti_Basho	P_t_ellioti_Basho	P_t_ellioti_Basho
P_t_ellioti_Damien	P_t_ellioti_Damien	P_t_ellioti_Damien	P_t_ellioti_Damien
P_t_ellioti_Julie	P_t_ellioti_Julie	P_t_ellioti_Julie	P_t_ellioti_Julie
P_t_ellioti_Kopongo	P_t_ellioti_Kopongo	P_t_ellioti_Kopongo	P_t_ellioti_Kopongo
P_t_ellioti_Koto	P_t_ellioti_Koto	P_t_ellioti_Koto	P_t_ellioti_Koto
P_t_ellioti_Paquita	P_t_ellioti_Paquita	P_t_ellioti_Paquita	P_t_ellioti_Paquita
P_t_ellioti_Taweh	P_t_ellioti_Taweh	P_t_ellioti_Taweh	P_t_ellioti_Taweh
P_t_ellioti_Tobi	P_t_ellioti_Tobi	P_t_ellioti_Tobi	P_t_ellioti_Tobi
P_t_schweinfurthii_Vincent	P_t_schweinfurthii_Vincent	P_t_schweinfurthii_Vincent	P_t_schweinfurthii_Vincent
P_t_schweinfurthii_Andromeda	P_t_schweinfurthii_Andromeda	P_t_schweinfurthii_Andromeda	P_t_schweinfurthii_Andromeda
P_t_schweinfurthii_Harriet	P_t_schweinfurthii_Harriet	P_t_schweinfurthii_Harriet	P_t_schweinfurthii_Harriet
P_t_schweinfurthii_Bwambale	P_t_schweinfurthii_Bwambale	P_t_schweinfurthii_Bwambale	P_t_schweinfurthii_Bwambale
P_t_schweinfurthii_Kidongo	P_t_schweinfurthii_Kidongo	P_t_schweinfurthii_Kidongo	P_t_schweinfurthii_Kidongo
P_t_schweinfurthii_Nakuu	P_t_schweinfurthii_Nakuu	P_t_schweinfurthii_Nakuu	P_t_schweinfurthii_Nakuu
P_t_schweinfurthii_Padda	P_t_schweinfurthii_Padda	P_t_schweinfurthii_Padda	P_t_schweinfurthii_Padda
P_t_schweinfurthii_Cindy	P_t_schweinfurthii_Cindy	P_t_schweinfurthii_Cindy	P_t_schweinfurthii_Cindy
P_t_schweinfurthii_Frederike	P_t_schweinfurthii_Frederike	P_t_schweinfurthii_Frederike	P_t_schweinfurthii_Frederike
P_t_schweinfurthii_Washu	P_t_schweinfurthii_Washu	P_t_schweinfurthii_Washu	P_t_schweinfurthii_Washu
P_t_schweinfurthii_Athanga	P_t_schweinfurthii_Athanga	P_t_schweinfurthii_Athanga	P_t_schweinfurthii_Athanga
P_t_schweinfurthii_Coco	P_t_schweinfurthii_Coco	P_t_schweinfurthii_Coco	P_t_schweinfurthii_Coco
P_t_schweinfurthii_Tongo	P_t_schweinfurthii_Tongo	P_t_schweinfurthii_Tongo	P_t_schweinfurthii_Tongo
P_t_schweinfurthii_Cleo	P_t_schweinfurthii_Cleo	P_t_schweinfurthii_Cleo	P_t_schweinfurthii_Cleo
P_t_schweinfurthii_Bihati	P_t_schweinfurthii_Bihati	P_t_schweinfurthii_Bihati	P_t_schweinfurthii_Bihati
P_t_schweinfurthii_Maya	P_t_schweinfurthii_Maya	P_t_schweinfurthii_Maya	P_t_schweinfurthii_Maya
P_t_troglodytes_Cindy	P_t_troglodytes_Cindy	P_t_troglodytes_Cindy	P_t_troglodytes_Cindy
P_t_troglodytes_Mirinda	P_t_troglodytes_Mirinda	P_t_troglodytes_Mirinda	P_t_troglodytes_Mirinda
P_t_troglodytes_Alfred	P_t_troglodytes_Alfred	P_t_troglodytes_Alfred	P_t_troglodytes_Alfred
P_t_troglodytes_Ula	P_t_troglodytes_Ula	P_t_troglodytes_Ula	P_t_troglodytes_Ula
P_t_troglodytes_Lara	P_t_troglodytes_Lara	P_t_troglodytes_Lara	P_t_troglodytes_Lara
P_t_troglodytes_Luky	P_t_troglodytes_Luky	P_t_troglodytes_Luky	P_t_troglodytes_Luky
P_t_troglodytes_Gamin	P_t_troglodytes_Gamin	P_t_troglodytes_Gamin	P_t_troglodytes_Gamin
P_t_troglodytes_Brigitte	P_t_troglodytes_Brigitte	P_t_troglodytes_Brigitte	P_t_troglodytes_Brigitte
P_t_troglodytes_Vaillant	P_t_troglodytes_Vaillant	P_t_troglodytes_Vaillant	P_t_troglodytes_Vaillant
P_t_troglodytes_Doris	P_t_troglodytes_Doris	P_t_troglodytes_Doris	P_t_troglodytes_Doris
P_t_troglodytes_Julie	P_t_troglodytes_Julie	P_t_troglodytes_Julie	P_t_troglodytes_Julie
P_t_troglodytes_Clara	P_t_troglodytes_Clara	P_t_troglodytes_Clara	P_t_troglodytes_Clara
P_t_troglodytes_Noemie	P_t_troglodytes_Noemie	P_t_troglodytes_Noemie	P_t_troglodytes_Noemie
P_t_troglodytes_Yogui	P_t_troglodytes_Yogui	P_t_troglodytes_Yogui	P_t_troglodytes_Yogui
P_t_troglodytes_Tibe	P_t_troglodytes_Tibe	P_t_troglodytes_Tibe	P_t_troglodytes_Tibe
P_t_troglodytes_Blanguita	P_t_troglodytes_Blanguita	P_t_troglodytes_Blanguita	P_t_troglodytes_Blanguita
P_t_troglodytes_Negrita	P_t_troglodytes_Negrita	P_t_troglodytes_Negrita	P_t_troglodytes_Negrita
P_t_troglodytes_Marlin	P_t_troglodytes_Marlin	P_t_troglodytes_Marlin	P_t_troglodytes_Marlin
P_t_verus_Bosco	P_t_verus_Bosco	P_t_verus_Bosco	P_t_verus_Bosco
P_t_verus_Donald	P_t_verus_Donald	P_t_verus_Donald	P_t_verus_Donald
P_t_verus_Jimmie	P_t_verus_Jimmie	P_t_verus_Jimmie	P_t_verus_Jimmie
P_t_verus_Berta	P_t_verus_Berta	P_t_verus_Berta	P_t_verus_Berta
P_t_verus_Annie	P_t_verus_Annie	P_t_verus_Annie	P_t_verus_Annie
P_t_verus_Mike	P_t_verus_Mike	P_t_verus_Mike	P_t_verus_Mike
P_t_verus_SepP_t_oni	P_t_verus_SepP_t_oni	P_t_verus_SepP_t_oni	P_t_verus_SepP_t_oni
P_t_verus_Linda	P_t_verus_Linda	P_t_verus_Linda	P_t_verus_Linda
P_t_verus_Clint	P_t_verus_Clint	P_t_verus_Clint	P_t_verus_Clint
P_t_verus_Cindy	P_t_verus_Cindy	P_t_verus_Cindy	P_t_verus_Cindy
P_t_verus_Alice	P_t_verus_Alice	P_t_verus_Alice	P_t_verus_Alice
P_t_verus_Koby	P_t_verus_Koby	P_t_verus_Koby	P_t_verus_Koby
ZooChimp_00047	ZooChimp_00047	ZooChimp_00047	ZooChimp_00047
ZooChimp_11419	ZooChimp_11419	ZooChimp_11419	ZooChimp_11419
ZooChimp_12009	ZooChimp_12009	ZooChimp_12009	ZooChimp_12009
ZooChimp_12141	ZooChimp_12141	ZooChimp_12141	ZooChimp_12141
ZooChimp_12142	ZooChimp_12142	ZooChimp_12142	ZooChimp_12142
ZooChimp_12331	ZooChimp_12331	ZooChimp_12331	ZooChimp_12331
ZooChimp_12750	ZooChimp_12750	ZooChimp_12750	ZooChimp_12750
ZooChimp_13859	ZooChimp_13859	ZooChimp_13857	ZooChimp_13857
ZooChimp_14117	ZooChimp_14117	ZooChimp_14117	ZooChimp_14117
ZooChimp_14125	ZooChimp_14125	ZooChimp_14125	ZooChimp_14125
ZooChimp_14222	ZooChimp_14222	ZooChimp_14222	ZooChimp_14222
ZooChimp_14243	ZooChimp_14243	ZooChimp_14243	ZooChimp_14243
ZooChimp_14466	ZooChimp_14466	ZooChimp_14466	ZooChimp_14466
ZooChimp_15168	ZooChimp_15168	ZooChimp_15168	ZooChimp_15168
